#########################################
#.................#...#.....#...........#
#.###.###.#######.#.#.###.#.###.###.###.#
#...#...#.#.....#.#.#.....#...#.#...#O#.#
#.#####.###.###.#.#.#########.###.###.#.#
#.#...#.....#...#...#.#.....#...#...#.#.#
#.#.#.#.#####.#######.#.###.###.###.#.#.#
#.#.#.#...#.#.#.......#.#.#...#.#...#...#
###.#.###.#.#.#####.#.#.#.###.#.#.#####.#
#...#...#...#.#...#.#.#.#...#...#.#...#.#
#.#####.#####.#.#.#.###.#.#.#####.#.#.###
#.#...........#.#...#...#.#.#.....#.#...#
#.#############.#####.###.#.#.#.###.###.#
#...#...#...#.......#.#...#.#.#.#...#...#
#.#.#.#.#.#.#.#####.#.###.#.###.#.###.###
#.#...#...#.#.#...#...#...#.....#.#...#.#
#.#########.#.#.#.#####.#######.#.###.#.#
#.#...#.....#.#.#.......#.#.....#...#...#
#.###.#.#####.###.#.#####.#.#######.###.#
#.....#.....#.....#.#S..#.....#.....#.#.#
#########.#.#####.#####.#######.#####.#.#
#...#...#.#.....#.#...#.......#.#.....#.#
#.#.#.#.#######.#.#.#.#######.#.#.#.###.#
#.#.#.#.........#.#.#.......#...#.#.....#
#.#.#.#.###########.#######.#####.#######
#.#...#.#.......#...#.....#.....#.#.....#
#.#######.#####.#.#####.#.#.#####.#####.#
#.#.....#.#...#...#.....#.#.....#.#.....#
#.#.###.#.#.#########.###.#####.#.#.#####
#.#.#...#.#...........#.#...#.#...#.....#
#.#.#.###.#.#######.###.###.#.#########.#
#...#.....#...#...#.#...#...#.........#.#
#.#############.#.#.#.#.#.###.#######.#.#
#.......#...#...#...#.#...#.......#.#...#
#######.#.#.#.#######.#########.#.#.###.#
#.....#...#.#.....#.#...#.....#.#.#.#...#
#.#########.#.###.#.###.###.#.###.#.#.###
#...#.......#.#...#...#.#...#.....#.#...#
#.#.#.#########.###.#.#.#.#########.###.#
#.#.............#...#.....#.............#
#########################################
